tilegreen.gif
2
6aaaaaeaaaaaeaaaaac0
50000050000050000050
506aaa906ac03aaac050
50500000505000005050
3abaeaaababaaaeaba90
00005000010000500000
aaaad0022188007aaaaa
00005000000000500000
6aaafaaaaaaaaafaaac0
50005000000000500050
506ad06aeaeac07ac050
50505050505050505050
7a903ad03a907a903ad0
50000050000050000050
3aaaaabaaaaabaaaaa90
00000000000000000000

21111111111111111120
10000010000010000010
10111110111011111010
10100000101000001010
11111111111111111110
00001000000000100000
11111000000000111110
00001000000000100000
11110111101111011110
10001000000000100010
10110011111110011010
10101010101010101010
11101110111011101110
10000010000010000010
21111111111111111120
00000000000000000000

4aaaaa4aaaaa4aaaaa40
40000040000040000040
404888804a4022224040
40400000404000004040
22222222248888888880
00001000040000100000
222210008a2000188888
00001000000000100000
22221888802222188880
10001000000000100010
1022104a8a2a40188010
10101040101040101010
321018801a1022101810
10000010000010000010
1aaaaa1aaaaa1aaaaa10
00000000000000000000

11111111111111111111
11111233211111112321
11111233211111112431
11111111111111111221
11221111122111111111
11331111133111111111
11331112233221111111
11343212222221123211
11344311111111134311
11233211111111134211
11111111111111243111
11111111111123443111
11123333211123332111
11134334311111111111
11133113311111111111
11134213211111221111

76666666666666666667
65666605666655666656
66766606766765666766
66656667655676665666
65556666555566665556
76665566666666556667
66665687666678656666
66665687666678656666
76665566666666556667
65665566666666556656
66765676666667656766
66655665555556655666
65566556655665566556
65677656766765677656
65666655666655666656
76666666666666666667


00000000000000000000
00010511101010105510
00000633200000006620
00010077776700010320
00510000051700000000
00620170062101000000
00620005162517000000
00601176262620051100
00600200000070060400
00633201710000060700
00071000007000504700
00000010110151004070
00151111100163337070
00160330207000000000
00062006210000000000
00060106200000510000

72222222222222222223
70444405444440444413
73722205222373666373
73704445754344441373
73732222232322227373
10001500404000450000
22222552222665762222
00001574000057750000
22222622222222762223
70001544444044150013
73222322262223736373
73701375154543754373
73737373767373737373
75001043140575401043
73262273222273226273
10000000000000000000


