tilematrix.gif
2
aaeaaabac06aaaaaeaaa
00500000505000005000
227ac06ad07ac06ad880
10505050505050505010
10503a9050503a905010
00500000505000005000
aabaaaaa903aaaaabaaa
00000000000000000000
6aaeaeaaaaaaaeaeaac0
50050500010005050050
50050502218805050050
5069050000000503c050
505003eaaaaae9005050
50500050000050005050
3abaaabaaaaafaaaba90
00000010000040000000

11111111101111111110
00100000101000001000
00110011101100111000
00101010101010101000
00101110101011101000
00100000101000001000
11111111202111111110
00000000000000000000
11111111121111111110
10010100000001010010
10010100000001010010
10010100000001010010
10100111101111001010
10100010000010001010
21111111111111111120
00000000000000000000

22488888802222224888
00400000505000004000
48888048802240222240
40101040505040101040
00101880505022101000
00100000505000001000
22188888802222221888
00000000000000000000
22222222248888888880
10010100040001010010
100101008a2001010010
10210100000001018010
10100188aaa221001010
10100010000010001010
321aaa18aaa21aaa1890
00000010000040000000

12333488111188233311
11111455333342111111
41124414333244111114
32155413111244121123
77131113111321131177
77153334111353341177
33441111211231111133
34633412511121114223
43634311211123334113
12113311111111111112
13113437722773333411
34444337733773335521
11441111111111115541
11111122111112112111
33533366411146211143
11321188311188111131

999999bb9aa9bb999999
99bb9999b99b9999bb99
00cb9aa9b99b9aa9bc00
00cbb99bb99bb99bbc00
00999bb999999bb99900
0099a99a9999a99a9900
99bb9999b99b9999bb99
999999999aa999999999
a999999999999999999a
9b9bbbb99cc99bbbb9b9
99099990000009999099
99ab999000000999ba99
999ba9b999999b9ab999
99990abb9999bba09999
9bbb99bb9999bb99bbb9
a99999bb9999bb99999a


03111144100066311100
00000333111122000000
10000105333151000000
00063202000067000000
51020002000000020051
37061112000001120037
22520000000200000020
03111403200020000120
31114200200031112000
00002200000000000002
00002330413041111100
12013336211621111200
00320000000000006320
00000000000004006000
11111111100051700001
00000000000066000000

55555573545573555555
77457777126577771577
50661151726611517200
00051265126512651400
00026372626263726200
00026777626267776200
51261111726611117355
33333333323333333333
51111111111111111111
65315153373331515312
62062620010006262062
62072620000006263162
62652665555552264262
62620345333310256262
63731573555523117322
67777740777710777772


