tilewharf.gif
2
6aaeaae88c0005000000
50050050040005000000
506baad0040007aaa800
5050007aebaaad000000
50506a90500005000000
3ad05000500005000000
107ad06afaaaafaac000
72505050500005005880
40505050500005005000
6a9050503c0007aa9000
5000505003aaad000000
7aaebabc000005000000
50050007aaaaafaaac00
d00506a90100050003aa
3aaba900010005000000
00000000000005000000

21111111000001000000
10010010000001000000
10111110000001111000
10100011011111000000
10101110100001000000
11101000000001000000
00111021111111111000
00101010000001001000
00101010100001001000
11101010010001112000
10001010011111000000
11111111000001000000
10010001111111111100
10010011000001000110
21111100000001000000
00000000000000000000

62222222200004000000
40010010010004000000
40612250010004888800
4040002221888c000000
40404890100004000000
48404000100004000000
40488062322222224000
08801040100005002200
10101040100005001000
18105040180002221000
10005040032221000000
188a2224000001000000
10050002248889888800
10050221040001000188
32222100000001000000
00000000000001000000

11232111232111111111
11343111232111112321
11232111111111113431
21111111122111113431
31123332133111112321
21123332122111111111
11233332111112211111
32344443112212211111
32233332112211111111
23211111111111111111
34311232111111111221
34311343221111111221
23211232221111111111
11222321111111111111
11332321112332111111
11331111113443111111

68888888677007700000
75855855666007700000
77655857066007588860
77758855855885588860
77776855558885700000
75577586770007700000
68555768558885588600
86755775558885585768
86777777770007707768
68577777756007585700
75867777655885588600
75885555668885700000
75855885588885588860
57077685588885588558
55855558666007700688
68888860077007700000


31122000625111007011
21715101044101111651
12043024600711101551
21121211165000771131
50062225015611110030
40700444004057000720
70662225010001570000
65107335131200476010
04000444017301110001
16206007005110000000
14510122100000010620
70501135621100260740
70440044030717700001
07121220000001000670
61157040001222070101
02152000111345077001

66266626204000200000
02062462404000200000
04604204062000422220
04020464204220200040
04046202620006200000
04046244020000200000
00640462042220422200
22026402620006206262
04040264020000200200
66046404042000420200
02040404064660200400
04660404200006200000
02062006466660466620
02262660600006200646
64604020462000200000
00000040004000200000


