tilewharf.gif
2
905005050007aaac003a
003aa905000500050000
000000050007ac03ac00
6aaaaaad000505000500
50000005000505000500
baaaaaa98e23abaaabaa
00000001050100000000
00000007afad00000000
00000004050400000000
aaeaaaac8b26aeaaaaea
00500005000505000050
007aac0500050506aad0
6ad00505000505050050
505007ad0007ababaad0
50500505000500000050
50500505000500000050

00100101000111110010
00111101000100010000
00000001000112001100
21101111000101000100
10000001000101000100
11111111000111111110
00000000000000000000
00000000000000000000
00000000000000000000
11111111000011111110
00100001000101000010
00011201000101021110
11100101000101010010
10100111000110111110
10100101000100000010
00000000000000000000

10100104000488880018
00322104000400010000
0000000400048c032400
62222224000404000400
40000004000404000400
22222226208c88888888
00000004010400000000
000000008f2000000000
00000001040100000000
22222223208988888888
00100001000101000010
001aac01000101042210
22100501000101040010
10100221000189888890
10100101000100000010
10100101000100000010

11111111111111111111
11112333211111111111
11223444311111111111
11332333211111111111
11331123333332122111
11331134444443122111
11331134433443111111
11331134311343111111
11331134311343112321
11221134433443113431
11111134444443113431
12332123333332112321
13443111111111111111
13443111111111111111
12332111122112333333
11111111122112333333

57770777700758886075
86758577700758857068
00688867700758675860
68888885700755768570
75888885700777700770
55888885766755588558
88888888666688888888
00000006666660000000
00000006666660000000
88888888666688888888
88558885766755588855
00758867700777768857
68558577700777775857
75570755700755555857
77770755700758888857
77770777700770000077


00000000000000000000
00001666200000000000
00151000300000000000
00130000300000000000
00730012262625015000
00150010077063073000
00730011044075000000
00150070300173000000
00730010500173001620
00030072022005007130
00000010010113007030
01662004004443000430
07015000000000000000
07215000000000000000
07003000012001226262
00000000073000404444

02020020200042222064
04042020400024462000
00000040200042204220
62222220400026200620
02000006200020200020
04222220262040466046
04040004404000400440
00000006262620000000
00000000404040000000
26226622262622622626
44620046204026200062
00046626400040266204
66020620200020202062
02620040400040404204
02020026200020000062
02020026200020000002


