tilematrix.gif
2
6ac0406ac06ac0406ac0
50504050505050405050
3afaaa9050503aaafa90
00500000505000005000
22506ac07ad06ac05880
00505050505050505000
6aba903ad07a903abac0
50000000505000000050
3aeac06ad07ac06aea90
00505050505050505000
22503a907ad03a905880
00500000505000005000
6afaaac050506aaafac0
50501050505050105050
3a90103a903a90103a90
00000000000000000000

21100011101110001120
10100010101010001010
11111110101011111110
00100000101000001000
00101110111011101000
00101010101010101000
11111011000110111110
00000000101000000000
11111011000110111110
00101010101010101000
00101110111011101000
00100000101000001000
11111110101011111110
10100010101010001010
21100011101110001120
00000000000000000000

6a400048802240004ac0
50401040101040104050
2262188010102218c880
00400000101000004000
088048801a1022402200
00104010101010401000
22188018903210221880
50000000505000000050
22488048c06240224880
00401040404040104000
088018804a4022102200
00100000404000001000
22324880404022489880
50104010404010401050
3a100018802210001a90
00000000000000000000

12347735112115775111
11227723113124774433
33411145335131111311
11311131113463333621
77632251114521211477
77511153411311533577
11312131544511311311
11436341544411311435
11113111544411311114
11113111544511311111
77335533633633533377
77411311311311122377
11311432311311131111
11311112411422341111
11437722533522773352
11147753411533773341

a99a00a99aa99a00a99a
9bb9009bb99bb9009bb9
9bbbccb999999bccbbb9
a9bb999a9999a999bb9a
00c9a99a9bb9a99a9c00
00c99bb99bb99bb99c00
a9bbb99bb99bb99bbb9a
9b999aa9b99b9aa999b9
9b999aa9b99b9aa999b9
a9bbb99bb99bb99bbb9a
00c99bb99bb99bb99c00
00c9a99a9bb9a99a9c00
a9bb999a9999a999bb9a
9bbbccb999999bccbbb9
9bb9009bb99bb9009bb9
a99a00a99aa99a00a99a


02030412000000042000
00236270000003622511
11100003112000000000
00000000000501111010
04017320003220000304
62200001100000011162
00000000010200000000
00310120023200000311
00000000010100000003
00000000076200000000
04113111111111311104
62100000000000003162
00000311000000000000
00000003200313320000
00310413111113041111
00056211200011621120

01110001110111000111
00120000126012006042
06731572626263152372
67453332626267771077
00620551637201146200
00020512651265126400
01732206726672037311
05777737126077377712
03111101726611011172
67454205426012001077
00620672637266726200
00026777651267776400
01761111026201117311
00157342026265734042
03720006726672000372
67770067776777006777


