tilestone.gif
2
06aaaeaaaaaaaeaaac00
05000500000005000500
0506afaaaeaaafac0500
05050500050005050500
07a9050405040503ad00
05000505050505000500
afaead03aba907aeafaa
05050500000005050500
050503aeaeaea9050500
05050005050500050500
0503aaad0507aaa90500
05000005050500000500
07aeaea90503aeaead00
05050500050005050500
03a903aaabaaa903a900
00000000000000000000

02111111111111111200
01000100000001000100
01011111111111110100
01010100000001010100
01110100000001011100
01000100000001000000
11111100000001111110
01010100000001010100
01010111111111010100
01010001010100010100
01010110010011010100
01000001010100000100
01111111010111111100
01010100010001010100
02110111111111011200
00000000000000000000

02222488aaa224888800
05000400000004000500
05022222248888880500
05010100040001010500
02210100040001018800
01000101040101000100
232221018a2101888988
01010100000001010100
01010188aaa221010100
01010001010100010100
01032221010188890100
01000001010100000100
01822221010188882100
01010100010001010100
03210322218889018900
00000000000000000000

11111111111111111111
11111111111111111111
11111111111111111111
11221111111111112211
11331115611561113311
11331117811781113311
11331111122111113311
11331111144111113311
11331111111111113311
11331111111111113311
11445615611561564411
11115615622561561111
11111111133111111111
11111111144111111111
11111111111111111111
11111111111111111111

bhaaaaaaaaaaaaaaaaic
bcd99ed999999ed99ebc
bcbhagfaaaaaagfaicbc
bcbcded99ed99edebcbc
bcfgbcbhicbhicbcfgbc
kcd9kcbcbcbcbcbj9ebj
agfaagbcfgfgbcfaagfa
9ededebj9999kcdeded9
icbcbcfaaaaaagbcbcbc
bcbcbj9ededed9kcbcbc
bcbcfaagbcbcfaagbcbc
bcbj999ebcbcd999kcbc
bcfaaaagbcbcfaaaagbc
bcdeded9kcbj90dedebc
bcfgbcfaagfaa0bcfgbc
bj99kj99999999kj99kc


00000000000000000100
00000000000000001020
01000110012020010000
70040000070700000400
70041070070007000410
01041000000000300400
70040070004027000400
00040007004010000410
71041717700700000410
07041067270010200400
01040060000001000420
77006616604660660000
00032021004010004070
01122073004000120000
00100700001007100200
00530101010100000000

00000000000000000000
00000000000000000000
00000000000000000000
00000000000000000000
00000000000000000000
00000000000000000000
00000000000000000000
00000000000000000000
00000000000000000000
00000000000000000000
00000000000000000000
00000000000000000000
00000000000000000000
00000000000000000000
00000000000000000000
00000000000000000000


