tilestone.gif
2
6aaaaaeac06aeaaaaac0
50000050505050000050
3aeac0505050506aea90
00503ad07ad07a905000
40500050505050005040
7a90407ad07ad0403ad0
50005050101050500050
7aaafad000007afaaad0
50005050404050500050
7ac0107ad07ad0106ad0
10500050505050005010
00506ad07ad07ac05000
6aba90505050503abac0
50000050505050000050
3aaaaaba903abaaaaa90
00000000000000000000

21111111101111111120
10000010101010000010
11111010101010111110
00101110111011101000
00100010101010001000
11100011101110001110
10000010101010000010
11110110000011011110
10000010101010000010
11100011101110001110
00100010101010001000
00101110111011101000
11111010101010111110
10000010101010000010
21111111101111111120
00000000000000000000

4aaaaa48c0624aaaaa40
40000040404040000040
224ac0404040406a4880
00403a404a404a904000
40400040404040004040
48800048802240002240
40011040101040100040
22225880000022588880
10004010404010400010
18800018802210002210
10100010101010001010
00106a101a101ac01000
221a90101010103a1880
10000010101010000010
1aaaaa1890321aaaaa10
00000000000000000000

11111111111111111111
11111111111111111221
12211111111111111331
14411122111111111441
56111144111111111156
55115611111111561155
11117811111111781111
11111111333311111111
11111111333311111111
11115611111111561111
56117811111111781156
55111111111111111155
11111433211111221111
11111433211111221111
11111111111111111111
11111111111111111111

haaaaaaaaihaaaaaaaai
cd9999edebcded9999eb
cfaaaicbcbcbcbhaaagb
j9edefgbcfgbcfgded9k
hicbj9ebcdebcd9kcbhi
cfgbhicfgbcfgbhicfgb
cd9kcbcdebcdebcbj9eb
cfaagfgbjkjkcfgfaagb
cd99edebhihicded99eb
cfaicbcfgbcfgbcbhagb
cdebjkcdebcdebjkcdeb
jkcbhagbcfgbcfaicbjk
hagfgdebcdebcdefgfai
cd999kcbcbcbcbj999eb
cfaaaagfgbcfgfaaaagb
j99999999kj99999999k


02012116010301004037
60300110200070202047
00400000300077000620
00400004221303067040
00007704001060000000
62100001120040004562
00100050200002000150
37111014555514707600
17307076777712211721
11360016077070001011
00170000503000001100
62120000101070001262
20700111110000041200
10670777720400620012
21230056611002102062
00776122511001000110

00000000000000000000
00000000000000000000
00000000000000000000
00000000000000000000
00000000000000000000
00000000000000000000
00000000000000000000
00000000000000000000
00000000000000000000
00000000000000000000
00000000000000000000
00000000000000000000
00000000000000000000
00000000000000000000
00000000000000000000
00000000000000000000


